*************
****44444****
***4444444***
**441111144**
**441111144**
*44117771144*
*41172227114*
*41722222714*
44172***27144
4172*****2714
4172*****2714
4172*****2714
4172*****2714
4172*****2714
4172*****2714
88888*8*88888
*************
*************
*************
*************
