0000000000
0151551110
0515115510
0111111110
0151511510
0111115110
0515151510
0111551110
0000000000

0000000000
6226222622
1111115111
1151111111
5111551151
1111001111
1150000111
1100000051
1000000005

5111111515
1555111115
0111151110
0051111500
0001511000
0000510000
6226622226
1111511111
0000000000

6622622626
0000000000
6000150002
2000110006
1002512001
0060110200
0200150020
6000000002
2620620226

2622226262
5111111511
2266222622
0000110000
0001331000
0000110000
6262262226
1511511151
6226222622

2601551026
6000000002
0000000000
0000660000
0002336000
0000220000
0200000020
6660000266
0200000020

1111511115
0000000001
1111515511
1000000000
6300000000
2222262226
0000000006
0000000032
2222622622

0000000000
0210220150
0250160510
0210250110
0610220160
0250000120
0611212620
0212262210
0216656510

0115005110
1511111511
5112116151
1522262211
5122662615
0112662510
0011225500
0001551000
0000110000

0000000000
0001100000
0016510000
0062111000
0115115000
0011111000
6225526200
0611122100
2222222222

1551111111
1111115511
5111111111
1115551111
0000000000
0300000600
0000000600
0000000000
0011110000

1151100000
1111100000
1511100005
1111100005
5115106005
1111100005
5111500000
1151106600
1111100000

2000000002
6055555506
0010110100
0111111110
0111111110
2010200102
2010000102
0001111000
2600000062

0111025021
1206021025
1200061110
0110025100
0021021010
2001061025
1112021061
0000000000
2662222622

0000220000
0002112000
0022112200
0620110260
3200110063
0620110220
0036116300
0002112000
0000330000

0002620000
0061512000
0021516000
0601510200
0211111600
0010001000
0010001000
0500000500
0000000000

0100000500
1050001010
1111111110
1262626210
1111111110
0001550000
0010001000
0100000100
5500000550

0000000000
0002200000
0620066000
6115511600
2101101602
2115511206
0110011002
1100001106
0110011002

0000000000
0000000000
0006226000
0011551100
0111111110
0106060110
6111111116
0616006160
0060000600

0000111000
0001111100
0111011110
0111111100
1111110000
1111111000
0111111100
0011111110
0001111000

0000000000
0000000000
0000000000
0000000000
0000000000
0000000000
0000000000
0000000000
0000000000