*************
*************
*************
***7*****7***
***7*****7***
****7***7****
****7***7****
***8888888***
***8888888***
**884888488**
**884888488**
*88888888888*
*88888888888*
*88888888888*
*8*8888888*8*
*8*8*****8*8*
*8*8*****8*8*
****88*88****
****88*88****
*************