8888888888888
4444444444444
7777777777777
5555555555555
6666666666666
3333333333333
*************
*************
*************
*************
*************
*************
*************
*************
*************
*************
*************
*************
*************
*************
