0000000000000
0000000000000
0000000000000
0000000000000
0000000000000
0000000000000
0000000000000
0000000000000
0000000000000
0000000000000
0000000000000
0000000000000
6226222622222
1111115111111
1151111111111
5111551151111
1111001111111
1150000111111
1100000051111
1000000005555
