5111111515
1555111115
0111151110
0051111500
0001511000
0000510000
6226622226
1111511111
0000000000