0000000000000
0015150511100
0051510155100
0011110111100
0015150115100
0011110151100
0051510515100
0011150511100
0000000000000
0000000000000
0015150511100
0051510155100
0011110111100
0015150115100
0011110151100
0051510515100
0011150511100
0000000000000
0000000000000
0015150511100